...........................................
....................................X......
.................................####......
...............................#...........
.............................#.............
...........................#...............
.........................#.................
.......................#...................
...................####....................
...WW......................................
..............................W............
.............####...........W.....W........
..1........................................
.....................................WWW...
#############....##########################
...........................................
...............##....W.W.WWW.W.............
.....................WWW.W.W.W.............
.....................W.W.WWW.W.............
###########################################
OYTHISISBETERETESTJEWEETZELLEF
50